111111111111111
1EP100010C10001
110000000100011
110C01111010001
111011000010001
10001C011110001
101010100011101
101C00101010001
10C111C01010101
100000001C001C1
111111111111111
111111111111111