1111111111111111111111111111111111111111111111111111111111
1E000000000000C0000000011111111111111101111111111111111111
1010010100100000000000000000000000000001111111111111111111
1010010010101010001001011111111111111101111111111111111111
1111111111111111111111111111111111111101111111111111111111
1111111111111111111111111111111111111101111111111111111111
1111111111111111111111111111111111111101111111111111111111
1111111111111111111111111111111111111101111111111111111111
11111111111111111111111111111111111111P0000000000000000001
1111111111111111111111111111111111111101111111111111111111
10000000000000C0000000000000000000000001111111111111111111
1010010100100000101001011101111111111111111111111111111111
1111111111111111111111111101111111111111111111111111111111
1111111111111111111111111101111111111111111111111111111111
1111111111111111111111111101111111111111111111111111111111
11111111111111111111111111C1111111111111111111111111111111
1111111111111111111111111111111111111111111111111111111111