1111111111111111
1E01000001000001
11P1000001000001
1000000001000001
1011000001000001
1011000001000001
1001000001000001
1101000001000001
1101000000000011
1001000000000011
1011000000000011
1C01000000000011
1001000000000011
1111111111111111