11111111111
1EP00000001
10000000001
100C000C001
10000000001
10000C00001
10000000001
10C00000C01
10000000001
10000000001
11111111111