11111111111
1EP100010C1
11010100001
110C0111101
11111100001
10001C01111
10101010001
101C0010101
10C111C0101
100000001C1
11111111111